w w w w w w w w w w w w w w w w w w w w w w w w w w w w w w w w w w w w w w w w
w . . . . . . . . . . . . . . . . . . . . . . . . . . . . . . . . . . . . . . w
w . . . . . . . . . . . . . . . . . . . . . . . . . . . . . . . . . . . . . . w
w . . . . . . . . . . . . . . . . . . . . . . . . . . . . . . . . . . . . . . w
w . . . . . . . . . . . . . . . . . . . . . . . . . . . . . . . . . . . . . . w
w . . . . . . . . . . . . . . . . . . . . . . . . . . . . . . . . . . . . . . w
w . . . . . . . . . . . . . . . . . . . . . . . . . . . . . . . . . . . . . . w
w . . . . . . . . . . . . . . . . . . . . . . . . . . . . . . . . . . . . . . w
w . . . . . . . . . . . . . . . . . . . . . . . . . . . . . . . . . . . . . . w
w . . . . . . . . . . . . . . . . . . . . . . . . . . . . . . . . . . . . . . w
w . . . . . . . . . . . . . . . . . . . . . . . . . . . . . . . . . . . . . . w
w . . . . . . . . . . . . . . . . . . . . . . . . . . . . . . . . . . . . . . w
w . . . . . . . . . . . . . . . . . . . . . . . . . . . . . . . . . . . . . . w
w . . . . . . . . . . . . . . . . . . . . . . . . . . . . . . . . . . . . . . w
x . . . . . . . . . . . . . . . . . . . . . . . . . . . . . . . . . . . . . . x
w . . . . . . . . . . . . . . . . . . . . . . . . . . . . . . . . . . . . . . w
w . . . . . . . . . . . . . . . . . . . . . . . . . . . . . . . . . . . . . . w
w . . . . . . . . . . . . . . . . . . . . . . . . . . . . . . . . . . . . . . w
w . . . . . . . . . . . . . . . . . . . . . . . . . . . . . . . . . . . . . . w
w . . . . . . . . . . . . . . . . . . . . . . . . . . . . . . . . . . . . . . w
w . . . . . . . . . . . . . . . . . . . . . . . . . . . . . . . . . . . . . . w
w . . . . . . . . . . . . . . . . . . . . . . . . . . . . . . . . . . . . . . w
w . . . . . . . . . . . . . . . . . . . . . . . . . . . . . . . . . . . . . . w
w . . . . . . . . . . . . . . . . . . . . . . . . . . . . . . . . . . . . . . w
w . . . . . . . . . . . . . . . . . . . . . . . . . . . . . . . . . . . . . . w
w . . . . . . . . . . . . . . . . . . . . . . . . . . . . . . . . . . . . . . w
w . . . . . . . . . . . . . . . . . . . . . . . . . . . . . . . . . . . . . . w
w . . . . . . . . . . . . . . . . . . . . . . . . . . . . . . . . . . . . . . w
w . . . . . . . . . . . . . . . . . . . . . . . . . . . . . . . . . . . . . . w
w w w w w w w w w w w w w w w w w w w w w w w w w w w w w w w w w w w w w w w w
