w w w w w w w w w w w w w w w w w w w w w w w w w w w w w w w w w w w w w w w w
w . . . . . . . . . . . . . . . . . . . . . . . . . . . . . . . . . . . . . . w
w . . . . . . . . . . . . . . . . . . . . . . . . . . . . . . . . . . . . . . w
w . . . . . . . . . . . . . . . . . . . . . . . . . . . . . . . . . . . . . . w
w . . . . . . . . . . . . . . . . . . . . . . . . . . . . . . . . . . . . . . w
w . . . . . . . . . . . . . . . . . . . . . . . . . . . . . . . . . . . . . . w
w . . . . . . . . . . . . . . . . . . . . . . . . . . . . . . . . . . . . . . w
w . . . . . . . . . . . . . . . . . . . . . . . . . . . . . . . . . . . . . . w
w . . . . . . . . . . . . . . . . . . . . . . . . . . . . . . . . . . . . . . w
w . . . . . . . . . . . . . . . . . . . . . . . . . . . . . . . . . . . . . . w
w . . . . . . . . . . . . . . . . . . . . . . . . . . . . . . . . . . . . . . w
w . . . . . . . . . . . . . . . . . . . . . . . . . . . . . . . . . . . . . . w
w . . . . . . . . . . . . . . . . . . . . . . . . . . . . . . . . . . . . . . w
w . . . . . . . . . . . . . . . . . . . . . . . . . . . . . . . . . . . . . . w
d . . . . . . . . . . . . . . . . . . . . . . . . . . . . . . . . . . . . . . d
w . . . . . . . . . . . . . . . . . . . . . . . . . . . . . . . . . . . . . . w
w . . . . . . . . . . . . . . . . . . . . . . . . . . . . . . . . . . . . . . w
w . . . . . . . . . . . . . . . . . . . . . . . . . . . . . . . . . . . . . . w
w . . . . . . . . . . . . . . . . . . . . . . . . . . . . . . . . . . . . . . w
w . . . . . . . . . . . . . . . . . . . . . . . . . . . . . . . . . . . . . . w
w . . . . . . . . . . . . . . . . . . . . . . . . . . . . . . . . . . . . . . w
w . . . . . . . . . . . . . . . . . . . . . . . . . . . . . . . . . . . . . . w
w . . . . . . . . . . . . . . . . . . . . . . . . . . . . . . . . . . . . . . w
w . . . . . . . . . . . . . . . . . . . . . . . . . . . . . . . . . . . . . . w
w . . . . . . . . . . . . . . . . . . . . . . . . . . . . . . . . . . . . . . w
w . . . . . . . . . . . . . . . . . . . . . . . . . . . . . . . . . . . . . . w
w . . . . . . . . . . . . . . . . . . . . . . . . . . . . . . . . . . . . . . w
w . . . . . . . . . . . . . . . . . . . . . . . . . . . . . . . . . . . . . . w
w . . . . . . . . . . . . . . . . . . . . . . . . . . . . . . . . . . . . . . w
w w w w w w w w w w w w w w w w w w w w w w w w w w w w w w w w w w w w w w w w
